11141,8,1,254.83882099808446,5,1,1,7,Potential Loyalists
18979,28,1,49.18582285531489,5,1,1,7,Potential Loyalists
11033,70,1,433.961797498552,3,1,1,5,At Risk
12799,262,1,769.7603991572288,1,1,2,4,At Risk
17389,90,1,2041.5187967716383,3,1,3,7,Potential Loyalists
18911,55,1,570.4300940395643,4,1,2,7,Potential Loyalists
11317,28,1,1143.4837929573212,5,1,3,9,Potential Loyalists
19873,31,1,6617.641648393686,4,1,5,10,Loyal Customers
13261,198,1,1486.4617328408603,1,1,3,5,At Risk
17607,217,2,3088.9110594829776,1,2,4,7,Potential Loyalists
15254,319,1,2220.6511110309652,1,1,3,5,At Risk
13622,348,1,1876.7649125100015,1,1,3,5,At Risk
19886,216,1,9481.699161659062,1,1,5,7,Potential Loyalists
19499,41,1,1709.8049535455639,4,1,3,8,Potential Loyalists
16924,248,1,2915.000794003004,1,1,4,6,At Risk
15162,294,1,9661.227031694427,1,1,5,7,Potential Loyalists
15296,136,1,4429.854257867864,1,1,4,6,At Risk
19413,182,1,3634.138685073403,1,1,4,6,At Risk
10798,65,1,3211.2840648194465,3,1,4,8,Potential Loyalists
17008,78,1,3830.8311055271424,3,1,4,8,Potential Loyalists
14837,125,1,245.59323702087482,1,1,1,3,Hibernating
17754,225,1,3606.371523796361,1,1,4,6,At Risk
17837,220,1,698.8018310534528,1,1,2,4,At Risk
16828,215,1,4125.31863145957,1,1,4,6,At Risk
17437,232,1,476.0543068581647,1,1,1,3,Hibernating
13188,49,1,975.1130277022876,4,1,2,7,Potential Loyalists
18334,356,1,1666.5989871682,1,1,3,5,At Risk
13398,33,1,240.8777289934751,4,1,1,6,At Risk
13225,145,1,906.9878492811977,1,1,2,4,At Risk
16232,257,1,710.0801863339688,1,1,2,4,At Risk
18307,231,1,644.7730611317074,1,1,2,4,At Risk
18881,108,1,5704.725326308436,2,1,5,8,Potential Loyalists
17036,25,1,1766.3604421709174,5,1,3,9,Potential Loyalists
14846,223,1,1151.134081650068,1,1,3,5,At Risk
14054,255,1,573.7245697657233,1,1,2,4,At Risk
11243,201,1,188.14668551090742,1,1,1,3,Hibernating
15594,300,1,1163.7336180100376,1,1,3,5,At Risk
16391,283,1,2877.3835923034308,1,1,4,6,At Risk
16257,131,1,413.3944302100353,1,1,1,3,Hibernating
14284,276,1,632.1753814057058,1,1,2,4,At Risk
19733,38,1,709.6191980889797,4,1,2,7,Potential Loyalists
19627,70,1,695.4970986825789,3,1,2,6,At Risk
15966,224,1,275.2554778443568,1,1,1,3,Hibernating
12757,342,1,284.87240152370543,1,1,1,3,Hibernating
11894,347,1,11750.876940033977,1,1,5,7,Potential Loyalists
12118,51,1,607.1286510872828,4,1,2,7,Potential Loyalists
16947,93,1,823.4147648669448,2,1,2,5,At Risk
17396,83,1,605.9211173883309,3,1,2,6,At Risk
17265,183,1,304.58834625346526,1,1,1,3,Hibernating
18107,275,1,2411.079790911776,1,1,3,5,At Risk
18750,281,1,336.54412037864904,1,1,1,3,Hibernating
15968,23,1,3695.195950382843,5,1,4,10,Loyal Customers
17774,225,1,1504.9273164655833,1,1,3,5,At Risk
11478,69,1,2307.3141663333936,3,1,3,7,Potential Loyalists
14085,191,1,196.5806425926717,1,1,1,3,Hibernating
14658,106,1,336.42360244659517,2,1,1,4,At Risk
13494,341,1,6034.4693029181235,1,1,5,7,Potential Loyalists
12014,242,1,1341.6188074586426,1,1,3,5,At Risk
16801,260,1,246.68852830090088,1,1,1,3,Hibernating
19947,0,1,580.9710323525159,5,1,2,8,Potential Loyalists
16738,223,1,2226.9504617975767,1,1,3,5,At Risk
19915,128,1,564.4999871001892,1,1,2,4,At Risk
10371,61,2,2321.8427334838266,3,2,3,8,Potential Loyalists
19603,358,1,4348.137669381195,1,1,4,6,At Risk
12080,89,1,3493.438614827354,3,1,4,8,Potential Loyalists
11627,146,1,847.9548661789952,1,1,2,4,At Risk
18105,104,1,3782.5881341369413,2,1,4,7,Potential Loyalists
10626,331,1,52.80556026887214,1,1,1,3,Hibernating
13830,25,1,341.12966291186683,5,1,1,7,Potential Loyalists
17798,39,1,1454.4942859561847,4,1,3,8,Potential Loyalists
19642,227,1,1681.7163036157954,1,1,3,5,At Risk
11174,79,1,1120.3638485455542,3,1,3,7,Potential Loyalists
19316,206,1,4067.73447213266,1,1,4,6,At Risk
14703,246,1,955.9491935538142,1,1,2,4,At Risk
16671,260,1,4610.37986800121,1,1,4,6,At Risk
15060,239,1,2406.533302341276,1,1,3,5,At Risk
17297,223,1,4602.024869927414,1,1,4,6,At Risk
15398,350,1,2650.1665161592214,1,1,4,6,At Risk
14180,142,1,515.0412878265103,1,1,2,4,At Risk
11912,77,1,253.2714865272489,3,1,1,5,At Risk
10272,345,1,1544.3322698851025,1,1,3,5,At Risk
18895,146,1,4437.227055287317,1,1,4,6,At Risk
15840,81,1,633.710322766331,3,1,2,6,At Risk
13775,176,1,2710.0537826954296,1,1,4,6,At Risk
14056,108,1,849.641373871925,2,1,2,5,At Risk
18693,260,1,1628.7865206786182,1,1,3,5,At Risk
13676,13,1,591.7953043463164,5,1,2,8,Potential Loyalists
10506,229,1,2247.2271807495154,1,1,3,5,At Risk
17148,194,1,451.7968708880775,1,1,1,3,Hibernating
16175,41,1,1597.5143408583706,4,1,3,8,Potential Loyalists
15583,253,1,413.22366943743685,1,1,1,3,Hibernating
19928,339,1,4740.6496479997,1,1,4,6,At Risk
16331,180,1,4789.801391011843,1,1,4,6,At Risk
12597,221,1,1099.6103601281052,1,1,3,5,At Risk
19241,56,1,172.2131994346468,4,1,1,6,At Risk
17244,294,1,1797.1237397705836,1,1,3,5,At Risk
16326,109,1,2406.5816009148884,2,1,3,6,At Risk
12601,117,1,409.71521660353756,2,1,1,4,At Risk
10861,27,1,335.8869012052413,5,1,1,7,Potential Loyalists
13081,210,1,3685.5158954695235,1,1,4,6,At Risk
12575,26,1,142.64646746744648,5,1,1,7,Potential Loyalists
17813,310,1,3785.644591760925,1,1,4,6,At Risk
10228,313,1,2449.4286703325783,1,1,3,5,At Risk
13992,209,1,1145.5297486386737,1,1,3,5,At Risk
11133,44,1,2721.558109311584,4,1,4,9,Potential Loyalists
14961,363,1,2592.7598425377923,1,1,4,6,At Risk
15051,154,1,3244.633352277693,1,1,4,6,At Risk
15599,41,1,1042.9282549817449,4,1,3,8,Potential Loyalists
12659,325,1,1511.334880422413,1,1,3,5,At Risk
16413,240,1,616.5482249463554,1,1,2,4,At Risk
11677,131,1,1094.0470688829753,1,1,3,5,At Risk
17928,311,1,396.0621027109091,1,1,1,3,Hibernating
19145,100,1,243.41579033387336,2,1,1,4,At Risk
17345,104,1,10526.200897779145,2,1,5,8,Potential Loyalists
15454,217,1,2786.585520432962,1,1,4,6,At Risk
16240,162,1,3647.080336436096,1,1,4,6,At Risk
18876,81,1,1349.559515988309,3,1,3,7,Potential Loyalists
11367,265,1,4745.574249136489,1,1,4,6,At Risk
14565,291,1,1929.7383230780222,1,1,3,5,At Risk
17966,266,1,206.24220087902816,1,1,1,3,Hibernating
14813,143,1,1267.692184623302,1,1,3,5,At Risk
12895,36,1,50.13183083756779,4,1,1,6,At Risk
13644,362,1,350.4957696842187,1,1,1,3,Hibernating
12841,131,1,266.46571170628795,1,1,1,3,Hibernating
18572,342,1,11174.21230900579,1,1,5,7,Potential Loyalists
17825,39,1,4254.69565318507,4,1,4,9,Potential Loyalists
11260,29,1,2461.1935544564544,5,1,3,9,Potential Loyalists
18448,244,1,1563.8333028650493,1,1,3,5,At Risk
12881,347,1,1086.4645516457756,1,1,3,5,At Risk
15974,348,1,3838.9641494641037,1,1,4,6,At Risk
18864,236,1,2193.601685823872,1,1,3,5,At Risk
15696,316,1,8110.287637502623,1,1,5,7,Potential Loyalists
10864,59,1,244.74457920381306,4,1,1,6,At Risk
13440,27,2,3066.824341863258,5,2,4,11,Loyal Customers
19211,92,1,4670.971872963808,2,1,4,7,Potential Loyalists
15593,316,1,1881.2613277310772,1,1,3,5,At Risk
14151,42,1,1808.4961969749402,4,1,3,8,Potential Loyalists
14041,351,1,1855.025701226904,1,1,3,5,At Risk
15540,41,2,3326.349072300563,4,2,4,10,Loyal Customers
10913,330,1,3274.034750707834,1,1,4,6,At Risk
17204,176,1,1352.6118441187632,1,1,3,5,At Risk
15543,51,1,5868.137217411069,4,1,5,10,Loyal Customers
16394,114,1,676.7238709947173,2,1,2,5,At Risk
16470,270,1,4762.720225203753,1,1,4,6,At Risk
12639,245,1,1356.1562444187975,1,1,3,5,At Risk
12158,352,1,6864.604670703312,1,1,5,7,Potential Loyalists
14588,356,1,1546.305782703143,1,1,3,5,At Risk
14327,86,1,2985.5262570016885,3,1,4,8,Potential Loyalists
15452,263,1,7370.678964554187,1,1,5,7,Potential Loyalists
19297,46,1,789.2825417793665,4,1,2,7,Potential Loyalists
11342,255,1,4111.225727131937,1,1,4,6,At Risk
12962,340,1,301.7928756653116,1,1,1,3,Hibernating
15882,90,2,1005.1067042022029,3,2,3,8,Potential Loyalists
16191,303,1,1705.3504950662423,1,1,3,5,At Risk
19088,357,1,101.32430031505233,1,1,1,3,Hibernating
16637,102,1,642.8629988471507,2,1,2,5,At Risk
12170,26,1,624.7390202542865,5,1,2,8,Potential Loyalists
17915,359,1,5041.609125142002,1,1,5,7,Potential Loyalists
16155,204,1,4298.489177512929,1,1,4,6,At Risk
19103,327,1,78.83993040570815,1,1,1,3,Hibernating
11353,257,1,3664.177797164571,1,1,4,6,At Risk
15014,136,2,2565.180112175305,1,2,4,7,Potential Loyalists
14534,262,1,3279.7602149349805,1,1,4,6,At Risk
19643,262,2,7823.557699467116,1,2,5,8,Potential Loyalists
12580,138,1,8500.092475501775,1,1,5,7,Potential Loyalists
10240,299,1,422.8285965048261,1,1,1,3,Hibernating
12035,217,1,690.7372822108584,1,1,2,4,At Risk
13829,21,1,4078.310584113203,5,1,4,10,Loyal Customers
13339,7,1,11222.549249084766,5,1,5,11,Loyal Customers
17531,273,1,3012.959637606815,1,1,4,6,At Risk
16533,143,1,4895.780462371678,1,1,4,6,At Risk
18947,292,1,2911.1409047434963,1,1,4,6,At Risk
15560,21,1,1908.7372842480286,5,1,3,9,Potential Loyalists
15806,37,1,818.7110443815204,4,1,2,7,Potential Loyalists
14571,21,1,795.124086727018,5,1,2,8,Potential Loyalists
16754,260,1,7549.244399290208,1,1,5,7,Potential Loyalists
18617,170,1,7200.687334848075,1,1,5,7,Potential Loyalists
17382,44,2,4590.868888941139,4,2,4,10,Loyal Customers
11882,253,1,1125.7742370218148,1,1,3,5,At Risk
10421,245,1,638.9192270255123,1,1,2,4,At Risk
17325,25,1,411.91266969623535,5,1,1,7,Potential Loyalists
15506,57,1,2308.2988752327133,4,1,3,8,Potential Loyalists
15811,29,1,84.58733345131694,5,1,1,7,Potential Loyalists
19216,85,1,1623.8677334209724,3,1,3,7,Potential Loyalists
17130,118,1,446.32703103593053,2,1,1,4,At Risk
16429,50,1,476.74899653208865,4,1,1,6,At Risk
13655,209,1,5001.7273349419565,1,1,5,7,Potential Loyalists
11335,306,1,492.69486248331464,1,1,1,3,Hibernating
11514,242,1,1525.5808241010948,1,1,3,5,At Risk
16411,180,1,7707.722335111214,1,1,5,7,Potential Loyalists
15801,280,1,1020.6384331229334,1,1,3,5,At Risk
16396,149,1,2948.982729240047,1,1,4,6,At Risk
19271,123,1,1483.1711496959736,1,1,3,5,At Risk
15602,43,1,1231.3394259799422,4,1,3,8,Potential Loyalists
17996,162,1,602.0132209905012,1,1,2,4,At Risk
10463,259,1,829.0535824580237,1,1,2,4,At Risk
11391,2,1,1518.3767034224772,5,1,3,9,Potential Loyalists
12994,200,1,2197.267572474615,1,1,3,5,At Risk
19035,310,1,412.376726028504,1,1,1,3,Hibernating
10666,230,1,75.12014368701786,1,1,1,3,Hibernating
19456,63,1,1247.69125167809,3,1,3,7,Potential Loyalists
17016,140,1,4602.191136976222,1,1,4,6,At Risk
12565,198,1,3552.7402786616767,1,1,4,6,At Risk
14815,175,1,5233.384347576653,1,1,5,7,Potential Loyalists
19837,323,1,2463.41144436514,1,1,3,5,At Risk
11773,100,1,650.2331996102293,2,1,2,5,At Risk
12062,163,1,108.79863583939647,1,1,1,3,Hibernating
17675,90,1,75.19746034051104,3,1,1,5,At Risk
10215,202,1,693.7480364467914,1,1,2,4,At Risk
19943,84,2,3351.1492266905216,3,2,4,9,Potential Loyalists
10556,129,1,1951.651063350259,1,1,3,5,At Risk
11001,318,1,572.3134545627579,1,1,2,4,At Risk
11539,329,1,389.55855472251045,1,1,1,3,Hibernating
17680,74,1,4273.860403799947,3,1,4,8,Potential Loyalists
12306,159,1,446.7591118317983,1,1,1,3,Hibernating
13779,238,1,4307.484120364603,1,1,4,6,At Risk
16578,289,1,1493.4179426616006,1,1,3,5,At Risk
10294,283,1,4423.309617369465,1,1,4,6,At Risk
11644,10,1,1130.719074874824,5,1,3,9,Potential Loyalists
14213,15,1,1227.0297642064806,5,1,3,9,Potential Loyalists
12936,333,1,2177.8660442473224,1,1,3,5,At Risk
14603,84,2,2203.495420477812,3,2,3,8,Potential Loyalists
10918,93,1,227.9761478247716,2,1,1,4,At Risk
19836,282,1,3731.150276324378,1,1,4,6,At Risk
17192,176,1,8523.014966675313,1,1,5,7,Potential Loyalists
19974,312,1,425.9013916639298,1,1,1,3,Hibernating
18044,58,1,2295.986285963967,4,1,3,8,Potential Loyalists
11030,116,1,1297.1439220032285,2,1,3,6,At Risk
10746,170,1,423.3092827622482,1,1,1,3,Hibernating
12644,196,1,2020.956897521423,1,1,3,5,At Risk
15753,138,1,4852.1639753667305,1,1,4,6,At Risk
12460,187,1,6587.707696091202,1,1,5,7,Potential Loyalists
18313,171,1,2288.2656458718334,1,1,3,5,At Risk
14248,13,1,974.2339032039064,5,1,2,8,Potential Loyalists
15074,177,1,7343.463698582286,1,1,5,7,Potential Loyalists
10283,157,1,2782.1302534160914,1,1,4,6,At Risk
16001,7,1,422.47710909155484,5,1,1,7,Potential Loyalists
15607,360,1,1117.9929360253475,1,1,3,5,At Risk
16587,299,1,323.37459709982954,1,1,1,3,Hibernating
18982,238,1,1680.8442541029876,1,1,3,5,At Risk
11581,150,1,823.7944451655447,1,1,2,4,At Risk
11248,2,1,5140.51531208947,5,1,5,11,Loyal Customers
12237,10,1,3768.0234796130253,5,1,4,10,Loyal Customers
12917,194,1,351.46854869583694,1,1,1,3,Hibernating
12155,81,2,720.6164206185766,3,2,2,7,Potential Loyalists
13768,236,1,8864.168002226794,1,1,5,7,Potential Loyalists
13892,39,1,248.58709080373634,4,1,1,6,At Risk
10643,173,1,3394.961457670748,1,1,4,6,At Risk
14675,116,1,591.7825075699319,2,1,2,5,At Risk
10390,132,1,261.2422051044915,1,1,1,3,Hibernating
19706,5,1,655.8322677872128,5,1,2,8,Potential Loyalists
14823,8,1,464.50266105858265,5,1,1,7,Potential Loyalists
17104,77,1,3010.965705868588,3,1,4,8,Potential Loyalists
12365,316,1,1004.9969147494005,1,1,3,5,At Risk
11211,107,1,104.13268526935194,2,1,1,4,At Risk
14657,40,1,2264.7647388929904,4,1,3,8,Potential Loyalists
19973,6,1,824.2425093326227,5,1,2,8,Potential Loyalists
10935,313,1,5004.441607544453,1,1,5,7,Potential Loyalists
14131,20,1,1165.1665993790755,5,1,3,9,Potential Loyalists
11357,195,1,604.2182800416421,1,1,2,4,At Risk
16719,297,1,1048.616307926276,1,1,3,5,At Risk
15247,43,1,48.559710324883945,4,1,1,6,At Risk
18832,10,1,424.4675626094267,5,1,1,7,Potential Loyalists
17080,135,2,1723.0215194172324,1,2,3,6,At Risk
18989,61,1,677.0051524889093,3,1,2,6,At Risk
14522,285,1,1463.4302309362354,1,1,3,5,At Risk
14524,39,1,2305.93453077504,4,1,3,8,Potential Loyalists
16120,215,1,823.6189987027401,1,1,2,4,At Risk
10507,319,1,1455.060897327219,1,1,3,5,At Risk
13786,61,1,2611.5711838509606,3,1,4,8,Potential Loyalists
13791,46,1,3300.0869500062513,4,1,4,9,Potential Loyalists
16146,165,1,211.34000323381028,1,1,1,3,Hibernating
19782,210,1,6248.205426936649,1,1,5,7,Potential Loyalists
19927,69,1,156.73033218988618,3,1,1,5,At Risk
11181,120,1,900.6281812096244,2,1,2,5,At Risk
18938,350,1,340.58546770955337,1,1,1,3,Hibernating
15476,343,1,593.2631026105562,1,1,2,4,At Risk
10378,248,1,244.50601173441697,1,1,1,3,Hibernating
18518,295,1,335.11287015562317,1,1,1,3,Hibernating
12296,268,1,2552.5710267144145,1,1,4,6,At Risk
10325,343,1,1301.766448902176,1,1,3,5,At Risk
19030,343,1,7205.76541957871,1,1,5,7,Potential Loyalists
11045,261,1,712.465824366978,1,1,2,4,At Risk
16358,235,1,575.3120083964537,1,1,2,4,At Risk
12350,208,1,1949.4219204190729,1,1,3,5,At Risk
14476,162,1,208.09953366353878,1,1,1,3,Hibernating
15823,251,1,5879.291033040249,1,1,5,7,Potential Loyalists
10734,91,1,2519.724482870788,2,1,4,7,Potential Loyalists
10571,210,1,2119.8516522096097,1,1,3,5,At Risk
15325,30,1,51.26457019676928,5,1,1,7,Potential Loyalists
11390,22,1,8130.8140070620575,5,1,5,11,Loyal Customers
18219,360,1,9986.182363547261,1,1,5,7,Potential Loyalists
19951,290,1,1264.3213044751703,1,1,3,5,At Risk
10271,271,1,585.0966019015303,1,1,2,4,At Risk
10171,173,1,4464.583779089543,1,1,4,6,At Risk
12598,87,1,490.0199158953986,3,1,1,5,At Risk
16726,98,1,200.18476098430784,2,1,1,4,At Risk
14482,81,1,778.3143811217049,3,1,2,6,At Risk
16770,128,1,941.8344956662804,1,1,2,4,At Risk
13629,329,1,1126.6906029535403,1,1,3,5,At Risk
12964,361,1,976.4504503954918,1,1,2,4,At Risk
14225,125,1,1090.5696910532315,1,1,3,5,At Risk
15231,263,1,1080.711688686506,1,1,3,5,At Risk
18346,181,1,5292.046901311377,1,1,5,7,Potential Loyalists
17209,122,1,4016.0592488889206,1,1,4,6,At Risk
11192,327,1,329.353065237465,1,1,1,3,Hibernating
13496,224,1,243.12156613079148,1,1,1,3,Hibernating
13789,239,1,6324.891037086662,1,1,5,7,Potential Loyalists
14645,38,1,292.9003685397465,4,1,1,6,At Risk
11893,217,1,5261.218147459557,1,1,5,7,Potential Loyalists
10001,331,1,826.0474038735556,1,1,2,4,At Risk
10190,107,1,2093.5532523210163,2,1,3,6,At Risk
15649,35,1,99.07157999845668,4,1,1,6,At Risk
17500,91,1,5992.977204765459,2,1,5,8,Potential Loyalists
18514,361,1,208.10560823432917,1,1,1,3,Hibernating
11269,192,2,2010.2355413152363,1,2,3,6,At Risk
13199,181,2,8039.5135318293815,1,2,5,8,Potential Loyalists
16464,51,1,1559.314892265988,4,1,3,8,Potential Loyalists
13917,154,1,5943.493284321134,1,1,5,7,Potential Loyalists
18462,311,1,3289.983394091081,1,1,4,6,At Risk
18052,274,1,477.9415884176072,1,1,1,3,Hibernating
11462,37,2,2752.1802296558117,4,2,4,10,Loyal Customers
16297,361,1,468.3674944189205,1,1,1,3,Hibernating
11990,195,1,422.52045181937456,1,1,1,3,Hibernating
14818,148,1,1255.0713047595993,1,1,3,5,At Risk
17465,189,2,1660.1299499692414,1,2,3,6,At Risk
17669,201,1,2240.696701631662,1,1,3,5,At Risk
16899,302,1,1902.8925523686144,1,1,3,5,At Risk
14942,199,1,676.4925074042505,1,1,2,4,At Risk
13624,127,1,5500.159942861356,1,1,5,7,Potential Loyalists
11412,255,1,2268.6121203919683,1,1,3,5,At Risk
12630,69,1,3099.2191250513424,3,1,4,8,Potential Loyalists
14932,272,1,839.4842623253949,1,1,2,4,At Risk
10512,332,1,1102.9749731386555,1,1,3,5,At Risk
11986,115,1,1934.1488889168609,2,1,3,6,At Risk
12925,92,1,372.5026967639821,2,1,1,4,At Risk
11283,99,1,2559.056498986545,2,1,4,7,Potential Loyalists
11577,191,1,6928.937830939463,1,1,5,7,Potential Loyalists
14399,298,1,3420.634120843684,1,1,4,6,At Risk
14535,319,1,356.7967039130705,1,1,1,3,Hibernating
14616,180,1,1160.641694157626,1,1,3,5,At Risk
18081,285,1,3663.733763901309,1,1,4,6,At Risk
15930,105,1,2032.4060373500438,2,1,3,6,At Risk
11652,70,1,4429.71433919806,3,1,4,8,Potential Loyalists
16080,49,1,4642.198342058796,4,1,4,9,Potential Loyalists
10498,268,1,10902.538418102607,1,1,5,7,Potential Loyalists
11073,150,1,486.0052993222126,1,1,1,3,Hibernating
16678,149,1,3885.475086055291,1,1,4,6,At Risk
15585,33,1,1647.531864293775,4,1,3,8,Potential Loyalists
16893,199,1,97.9192317749521,1,1,1,3,Hibernating
12172,238,1,1292.6688813455814,1,1,3,5,At Risk
15953,179,1,4746.350636636479,1,1,4,6,At Risk
18092,282,1,183.28094740845884,1,1,1,3,Hibernating
19130,22,1,680.2534866045718,5,1,2,8,Potential Loyalists
19906,151,1,1288.4185891059317,1,1,3,5,At Risk
10220,262,1,1741.4929172429634,1,1,3,5,At Risk
18737,160,2,882.130726708001,1,2,2,5,At Risk
17509,348,1,6115.967379284936,1,1,5,7,Potential Loyalists
15818,265,1,1361.2315916511309,1,1,3,5,At Risk
18274,332,1,299.81373111000295,1,1,1,3,Hibernating
17995,321,1,1519.6259902823228,1,1,3,5,At Risk
14943,358,1,1009.1164243584134,1,1,3,5,At Risk
12706,305,1,966.3996588475532,1,1,2,4,At Risk
12395,223,1,1389.793373280286,1,1,3,5,At Risk
15338,302,1,1245.0070297796433,1,1,3,5,At Risk
12226,191,1,6027.409516663358,1,1,5,7,Potential Loyalists
11184,204,1,1899.644574026602,1,1,3,5,At Risk
16998,255,1,1208.406121103744,1,1,3,5,At Risk
18376,301,1,1087.2534278826438,1,1,3,5,At Risk
19615,49,1,78.35917051038547,4,1,1,6,At Risk
16219,253,1,994.9901930527498,1,1,2,4,At Risk
10026,84,1,5090.737160635724,3,1,5,9,Potential Loyalists
19959,202,1,1562.0026601033103,1,1,3,5,At Risk
12173,94,1,4982.789493034629,2,1,4,7,Potential Loyalists
19856,190,1,190.10584122485147,1,1,1,3,Hibernating
11784,311,1,1224.7294932127882,1,1,3,5,At Risk
18134,202,1,2168.2318953192953,1,1,3,5,At Risk
13346,185,1,5925.146405707514,1,1,5,7,Potential Loyalists
13510,91,2,2390.091006986185,2,2,3,7,Potential Loyalists
19407,325,1,95.91309083224971,1,1,1,3,Hibernating
14516,6,1,3012.635071852082,5,1,4,10,Loyal Customers
16221,265,1,757.0748801449033,1,1,2,4,At Risk
15618,205,1,1357.5712037544793,1,1,3,5,At Risk
19709,351,1,406.378092567778,1,1,1,3,Hibernating
14567,262,1,1763.3620058248844,1,1,3,5,At Risk
11191,24,2,2867.009919160844,5,2,4,11,Loyal Customers
13553,189,1,4351.11596803302,1,1,4,6,At Risk
12339,9,1,184.14714322937107,5,1,1,7,Potential Loyalists
16477,353,1,2372.6684939186025,1,1,3,5,At Risk
18264,345,1,2186.6520157483924,1,1,3,5,At Risk
14938,143,1,1214.5391541602517,1,1,3,5,At Risk
14042,112,1,161.70816601170395,2,1,1,4,At Risk
12364,7,1,725.0410183543565,5,1,2,8,Potential Loyalists
16360,339,1,1096.3414685042283,1,1,3,5,At Risk
17445,151,1,2298.24256604354,1,1,3,5,At Risk
16449,47,1,4607.315128848224,4,1,4,9,Potential Loyalists
14155,43,1,9007.016971369352,4,1,5,10,Loyal Customers
15673,225,1,802.3768508252556,1,1,2,4,At Risk
17189,289,1,565.8413257659064,1,1,2,4,At Risk
15515,166,1,2175.3654975432573,1,1,3,5,At Risk
17264,45,1,3285.6196191601225,4,1,4,9,Potential Loyalists
15326,161,1,1144.2241917268097,1,1,3,5,At Risk
11490,276,1,155.21322400032633,1,1,1,3,Hibernating
16040,230,2,3559.862724870908,1,2,4,7,Potential Loyalists
18386,1,1,5169.5657358533645,5,1,5,11,Loyal Customers
19971,286,1,4745.264657471464,1,1,4,6,At Risk
14780,37,1,3633.5883431276707,4,1,4,9,Potential Loyalists
17620,207,1,10485.426078163517,1,1,5,7,Potential Loyalists
15919,277,1,2436.8657332130206,1,1,3,5,At Risk
12987,204,1,605.6685024504771,1,1,2,4,At Risk
16911,86,1,1426.6765868461262,3,1,3,7,Potential Loyalists
17701,323,1,1172.5472430877555,1,1,3,5,At Risk
10813,101,1,1048.112944651902,2,1,3,6,At Risk
19399,158,1,1830.399167274098,1,1,3,5,At Risk
16646,15,1,478.1442257903757,5,1,1,7,Potential Loyalists
13340,54,1,2847.771611286319,4,1,4,9,Potential Loyalists
19350,305,1,190.56017399837864,1,1,1,3,Hibernating
17769,5,1,1439.6571405777092,5,1,3,9,Potential Loyalists
17533,316,1,707.3251138301328,1,1,2,4,At Risk
17236,174,1,409.21072604745916,1,1,1,3,Hibernating
13389,271,1,1486.6857469311758,1,1,3,5,At Risk
19726,64,1,276.7128369929474,3,1,1,5,At Risk
17164,33,1,3607.306833928553,4,1,4,9,Potential Loyalists
18435,299,1,7701.016152619221,1,1,5,7,Potential Loyalists
12410,56,1,395.2458822409846,4,1,1,6,At Risk
12381,307,1,196.1827462561607,1,1,1,3,Hibernating
16054,21,1,1801.8825640837342,5,1,3,9,Potential Loyalists
13153,110,1,2285.924624054854,2,1,3,6,At Risk
19190,290,1,1851.1747698047134,1,1,3,5,At Risk
16362,158,1,72.10011953642352,1,1,1,3,Hibernating
11378,165,1,3334.790583931146,1,1,4,6,At Risk
14174,13,1,1873.0689536958673,5,1,3,9,Potential Loyalists
13672,305,1,5932.902587168974,1,1,5,7,Potential Loyalists
19112,310,1,7458.0467777296835,1,1,5,7,Potential Loyalists
16957,359,1,6007.359251499735,1,1,5,7,Potential Loyalists
15197,89,1,384.7383600567414,3,1,1,5,At Risk
18921,341,1,1317.3911650387213,1,1,3,5,At Risk
11689,3,1,181.69369115089535,5,1,1,7,Potential Loyalists
18516,283,1,921.5308668500861,1,1,2,4,At Risk
12244,239,1,145.9765742867064,1,1,1,3,Hibernating
11590,347,1,158.7156153081502,1,1,1,3,Hibernating
10901,76,2,4742.519089103107,3,2,4,9,Potential Loyalists
18611,264,1,1276.9693741601745,1,1,3,5,At Risk
12330,161,1,361.21415058294616,1,1,1,3,Hibernating
15077,12,1,10400.528732545758,5,1,5,11,Loyal Customers
17933,95,1,231.6825290705259,2,1,1,4,At Risk
10687,273,1,3685.645742843349,1,1,4,6,At Risk
14897,211,1,577.7790995221978,1,1,2,4,At Risk
12212,52,1,4414.787718607359,4,1,4,9,Potential Loyalists
11067,335,1,232.20155836242333,1,1,1,3,Hibernating
17440,61,1,5686.9710545214275,3,1,5,9,Potential Loyalists
12776,104,1,1375.5968679630032,2,1,3,6,At Risk
17943,169,1,405.9549404697765,1,1,1,3,Hibernating
11301,6,2,9125.115667016027,5,2,5,12,Loyal Customers
12313,60,1,2771.0874981447614,4,1,4,9,Potential Loyalists
17088,193,1,5135.552846868385,1,1,5,7,Potential Loyalists
15178,273,1,3878.2157698413293,1,1,4,6,At Risk
11706,225,1,960.5697283112461,1,1,2,4,At Risk
10534,352,1,883.8892429308999,1,1,2,4,At Risk
10983,340,1,1588.1788157579895,1,1,3,5,At Risk
11016,83,1,857.7672479205299,3,1,2,6,At Risk
14039,347,1,528.9432194195192,1,1,2,4,At Risk
18792,250,1,642.8770682833009,1,1,2,4,At Risk
19488,354,1,422.04540760963613,1,1,1,3,Hibernating
12261,189,1,2290.255662498725,1,1,3,5,At Risk
18302,309,1,2971.68822852655,1,1,4,6,At Risk
11436,303,1,2174.5388342258584,1,1,3,5,At Risk
19697,216,1,836.9851751127868,1,1,2,4,At Risk
15308,201,1,621.6663950877789,1,1,2,4,At Risk
15266,311,1,52.75911532807306,1,1,1,3,Hibernating
11567,354,1,9828.463172451382,1,1,5,7,Potential Loyalists
15586,148,1,734.2383543770155,1,1,2,4,At Risk
19269,180,2,2042.767302011736,1,2,3,6,At Risk
15603,225,1,1267.1971984585307,1,1,3,5,At Risk
11058,183,1,2449.8484716193334,1,1,3,5,At Risk
15089,72,1,1470.3707012055509,3,1,3,7,Potential Loyalists
10615,49,2,4781.388030447349,4,2,4,10,Loyal Customers
16010,296,1,196.77558446667888,1,1,1,3,Hibernating
10946,334,1,2489.630044957269,1,1,3,5,At Risk
18683,92,1,402.82943529453206,2,1,1,4,At Risk
19043,356,1,1169.644842455925,1,1,3,5,At Risk
19017,197,1,3017.730867029243,1,1,4,6,At Risk
13365,308,1,1176.56038925696,1,1,3,5,At Risk
12031,90,1,1018.8165561139426,3,1,3,7,Potential Loyalists
15068,175,1,839.2287192591382,1,1,2,4,At Risk
16269,344,1,739.4434295845267,1,1,2,4,At Risk
14683,246,2,2442.042044722731,1,2,3,6,At Risk
14734,38,1,143.63493896554817,4,1,1,6,At Risk
14386,6,1,923.7579624713139,5,1,2,8,Potential Loyalists
16681,154,2,4036.496465228979,1,2,4,7,Potential Loyalists
13237,214,1,2439.9285167618627,1,1,3,5,At Risk
17833,36,1,3951.276452200663,4,1,4,9,Potential Loyalists
16414,318,1,1507.0759455664358,1,1,3,5,At Risk
18316,314,1,11359.62777432018,1,1,5,7,Potential Loyalists
14086,10,3,2464.188950296145,5,2,3,10,Loyal Customers
19713,245,1,501.3850734576598,1,1,2,4,At Risk
16663,48,1,5651.643909198621,4,1,5,10,Loyal Customers
13662,84,1,139.13655808068032,3,1,1,5,At Risk
13729,352,1,1482.5239474913121,1,1,3,5,At Risk
14539,178,1,1681.2415502313415,1,1,3,5,At Risk
18243,24,1,1064.085364051804,5,1,3,9,Potential Loyalists
13605,75,1,3343.5088304716473,3,1,4,8,Potential Loyalists
16683,272,1,7884.537519090846,1,1,5,7,Potential Loyalists
10446,85,1,5038.234393332178,3,1,5,9,Potential Loyalists
13793,15,1,1145.507998735557,5,1,3,9,Potential Loyalists
16568,175,1,1591.4891191197764,1,1,3,5,At Risk
16089,51,1,295.8652117573974,4,1,1,6,At Risk
13899,0,1,2087.0997954768322,5,1,3,9,Potential Loyalists
12076,219,1,3373.0262739345253,1,1,4,6,At Risk
13957,36,1,1015.0818774572297,4,1,3,8,Potential Loyalists
18181,210,1,508.36050370081,1,1,2,4,At Risk
12568,301,1,5945.283785375943,1,1,5,7,Potential Loyalists
13124,243,1,588.7214162047333,1,1,2,4,At Risk
14471,225,1,433.78939877360824,1,1,1,3,Hibernating
12550,326,1,5062.629217661492,1,1,5,7,Potential Loyalists
13809,208,1,1930.8178576607272,1,1,3,5,At Risk
19401,26,1,4286.496315400883,5,1,4,10,Loyal Customers
16996,362,1,3465.868688677487,1,1,4,6,At Risk
11129,12,1,509.729242035347,5,1,2,8,Potential Loyalists
19158,171,1,7737.147927402792,1,1,5,7,Potential Loyalists
15214,296,1,4397.118634943245,1,1,4,6,At Risk
18111,202,1,969.3925319469116,1,1,2,4,At Risk
19739,150,1,150.99754197837308,1,1,1,3,Hibernating
11449,158,1,1092.4522893218314,1,1,3,5,At Risk
17891,23,1,1325.3698605318657,5,1,3,9,Potential Loyalists
13140,207,1,5765.877638678218,1,1,5,7,Potential Loyalists
16852,252,1,9070.757402993479,1,1,5,7,Potential Loyalists
13569,87,2,11151.125702973273,3,2,5,10,Loyal Customers
16937,26,1,9113.318218824928,5,1,5,11,Loyal Customers
11375,357,1,1010.4548639881588,1,1,3,5,At Risk
19462,253,1,2967.7207325865265,1,1,4,6,At Risk
12887,183,1,949.8245997851798,1,1,2,4,At Risk
12728,293,1,632.8996163904205,1,1,2,4,At Risk
13096,123,1,2099.2018945485615,1,1,3,5,At Risk
11985,40,2,2396.5004943961017,4,2,3,9,Potential Loyalists
15269,167,1,1298.4513892418531,1,1,3,5,At Risk
16430,19,1,280.143706706383,5,1,1,7,Potential Loyalists
17686,4,1,4387.876595173675,5,1,4,10,Loyal Customers
18861,134,1,3166.472746089869,1,1,4,6,At Risk
14661,18,1,1976.0232186037597,5,1,3,9,Potential Loyalists
11940,229,1,4590.64228118854,1,1,4,6,At Risk
14206,202,1,5120.440272882073,1,1,5,7,Potential Loyalists
19142,25,1,1852.2005056468738,5,1,3,9,Potential Loyalists
13715,130,1,313.0083297490968,1,1,1,3,Hibernating
17090,251,1,1150.8173638234343,1,1,3,5,At Risk
13462,238,1,4476.803182165495,1,1,4,6,At Risk
15185,42,1,1726.6070889603081,4,1,3,8,Potential Loyalists
13432,290,1,236.91094994191246,1,1,1,3,Hibernating
18531,244,1,927.6870986658788,1,1,2,4,At Risk
10599,351,1,10124.134504906728,1,1,5,7,Potential Loyalists
14443,201,1,441.8765312798646,1,1,1,3,Hibernating
17867,40,1,2167.464041958893,4,1,3,8,Potential Loyalists
14530,139,1,225.56380581159908,1,1,1,3,Hibernating
14362,139,1,1498.7111250695673,1,1,3,5,At Risk
17604,89,1,594.6443326079494,3,1,2,6,At Risk
12068,203,1,2144.416550220889,1,1,3,5,At Risk
14631,93,1,646.4543180668438,2,1,2,5,At Risk
19379,32,1,10128.540456049646,4,1,5,10,Loyal Customers
17450,355,1,721.957521759472,1,1,2,4,At Risk
12645,43,1,1049.1506758152252,4,1,3,8,Potential Loyalists
10662,130,1,292.9970543785321,1,1,1,3,Hibernating
14651,163,1,2357.442943919589,1,1,3,5,At Risk
10681,147,1,1636.1861189729584,1,1,3,5,At Risk
14994,247,1,667.7914327644407,1,1,2,4,At Risk
10343,116,1,3265.837138444183,2,1,4,7,Potential Loyalists
13159,100,1,258.21008565358926,2,1,1,4,At Risk
13956,334,1,839.6541719059314,1,1,2,4,At Risk
18042,136,1,805.0657638023173,1,1,2,4,At Risk
14623,307,1,5418.167218239143,1,1,5,7,Potential Loyalists
15521,56,1,7344.405303160373,4,1,5,10,Loyal Customers
18106,301,1,501.22847572434847,1,1,2,4,At Risk
14103,359,1,94.635671805787,1,1,1,3,Hibernating
17797,333,1,3082.0570302265965,1,1,4,6,At Risk
13968,40,1,261.5951840758117,4,1,1,6,At Risk
17893,342,1,424.5260621277492,1,1,1,3,Hibernating
10904,332,1,1278.2202497558474,1,1,3,5,At Risk
15606,342,1,2373.1481542030497,1,1,3,5,At Risk
13590,363,1,902.4062778404848,1,1,2,4,At Risk
11605,270,1,3092.0300990872083,1,1,4,6,At Risk
10787,124,1,9881.472852381432,1,1,5,7,Potential Loyalists
11754,323,1,325.21069475724926,1,1,1,3,Hibernating
12560,163,1,104.58469485827287,1,1,1,3,Hibernating
15033,195,1,1070.5963990661182,1,1,3,5,At Risk
14673,171,1,3828.4216641841113,1,1,4,6,At Risk
13966,114,1,282.963606974686,2,1,1,4,At Risk
19830,256,1,5142.233666652071,1,1,5,7,Potential Loyalists
13977,70,1,4233.622199164721,3,1,4,8,Potential Loyalists
14704,86,1,1543.622263968778,3,1,3,7,Potential Loyalists
11473,3,1,1256.694931806852,5,1,3,9,Potential Loyalists
19080,110,1,92.79197734719601,2,1,1,4,At Risk
15731,112,1,4839.3627829705565,2,1,4,7,Potential Loyalists
12716,250,1,1112.9014699389015,1,1,3,5,At Risk
18362,72,2,674.0029519616586,3,2,2,7,Potential Loyalists
17987,203,1,7578.566403198283,1,1,5,7,Potential Loyalists
19104,170,1,2454.472410638883,1,1,3,5,At Risk
18321,316,1,1368.3021429016185,1,1,3,5,At Risk
11725,186,1,1786.1482539318984,1,1,3,5,At Risk
12670,252,1,7077.3337719200845,1,1,5,7,Potential Loyalists
14306,136,1,452.34185572225044,1,1,1,3,Hibernating
10382,288,1,367.37343667779453,1,1,1,3,Hibernating
13797,183,1,159.5461577252042,1,1,1,3,Hibernating
16106,176,1,247.3193445131597,1,1,1,3,Hibernating
12778,239,1,426.119047215661,1,1,1,3,Hibernating
12371,328,1,1588.344245356052,1,1,3,5,At Risk
16060,336,1,4295.6848659798225,1,1,4,6,At Risk
18713,74,1,2097.1299899625265,3,1,3,7,Potential Loyalists
17370,176,1,1225.298821801821,1,1,3,5,At Risk
16079,339,1,1927.533884039041,1,1,3,5,At Risk
11861,150,1,1993.7564742403397,1,1,3,5,At Risk
16638,90,1,317.2424007003064,3,1,1,5,At Risk
12774,208,1,215.66843460810983,1,1,1,3,Hibernating
13020,173,1,4951.732784506772,1,1,4,6,At Risk
15969,248,1,1905.6854356339686,1,1,3,5,At Risk
15911,215,1,3790.970562583155,1,1,4,6,At Risk
14633,212,1,47.855087801185114,1,1,1,3,Hibernating
10731,356,1,2465.8054563957326,1,1,3,5,At Risk
19599,264,1,2361.5273748894324,1,1,3,5,At Risk
13618,142,1,1495.3033278874525,1,1,3,5,At Risk
17235,100,1,274.7134698554236,2,1,1,4,At Risk
10490,238,1,688.0519200155948,1,1,2,4,At Risk
19265,255,1,652.5761017474547,1,1,2,4,At Risk
19121,200,1,2339.750591984648,1,1,3,5,At Risk
12048,4,1,1269.1535017824297,5,1,3,9,Potential Loyalists
18226,187,1,3243.8492358151425,1,1,4,6,At Risk
19756,216,1,821.3652527269303,1,1,2,4,At Risk
17452,207,1,4540.005073165596,1,1,4,6,At Risk
12156,207,1,1043.8821448068672,1,1,3,5,At Risk
14563,341,1,403.3592059911813,1,1,1,3,Hibernating
19963,352,1,215.53856439691685,1,1,1,3,Hibernating
11867,288,1,164.92868466754157,1,1,1,3,Hibernating
19900,297,1,3545.8355019060377,1,1,4,6,At Risk
11820,119,1,926.4809226992909,2,1,2,5,At Risk
19196,307,1,4368.536820441158,1,1,4,6,At Risk
14677,133,1,600.4895352094121,1,1,2,4,At Risk
10279,59,1,1560.2602907584296,4,1,3,8,Potential Loyalists
15663,191,1,403.84258853313924,1,1,1,3,Hibernating
11551,7,1,240.98260276460312,5,1,1,7,Potential Loyalists
10404,354,1,305.82128296790864,1,1,1,3,Hibernating
14908,57,1,2326.5899368797095,4,1,3,8,Potential Loyalists
18022,351,1,701.4939758869585,1,1,2,4,At Risk
10920,329,1,1006.3154793549986,1,1,3,5,At Risk
14368,81,1,2017.93298942516,3,1,3,7,Potential Loyalists
10375,27,1,3267.068513253605,5,1,4,10,Loyal Customers
15810,263,1,2132.9952137414807,1,1,3,5,At Risk
18082,321,1,5050.849308669884,1,1,5,7,Potential Loyalists
19041,343,1,1600.5042239737436,1,1,3,5,At Risk
10066,112,1,588.4182158879365,2,1,2,5,At Risk
11104,345,1,1881.9105228810342,1,1,3,5,At Risk
12741,43,1,345.19005353280846,4,1,1,6,At Risk
14078,91,2,4387.096224298307,2,2,4,8,Potential Loyalists
19562,260,1,1625.6963419188555,1,1,3,5,At Risk
11167,42,1,10442.873130405078,4,1,5,10,Loyal Customers
14270,189,2,2772.4616014802223,1,2,4,7,Potential Loyalists
17601,119,1,1147.87227136092,2,1,3,6,At Risk
16468,334,1,326.41099147512494,1,1,1,3,Hibernating
14011,311,1,377.7425582553855,1,1,1,3,Hibernating
11366,208,1,2556.7768058411943,1,1,4,6,At Risk
14321,153,2,2918.716420587208,1,2,4,7,Potential Loyalists
16004,167,1,5499.280847548405,1,1,5,7,Potential Loyalists
16691,117,1,772.1274697265045,2,1,2,5,At Risk
15979,347,1,1306.1720289605466,1,1,3,5,At Risk
12938,335,1,1645.5911496861859,1,1,3,5,At Risk
10441,309,1,4690.76351310435,1,1,4,6,At Risk
13918,116,1,6508.593448561768,2,1,5,8,Potential Loyalists
18557,66,1,418.5053215762637,3,1,1,5,At Risk
19381,270,1,5141.887199053194,1,1,5,7,Potential Loyalists
18543,41,1,1638.6429199438144,4,1,3,8,Potential Loyalists
14922,191,1,643.5762645282887,1,1,2,4,At Risk
16365,253,1,4033.3171345734077,1,1,4,6,At Risk
13174,342,1,2374.2921224623433,1,1,3,5,At Risk
14920,266,1,927.4023635638393,1,1,2,4,At Risk
12646,337,1,3053.102961095393,1,1,4,6,At Risk
19082,10,1,2365.9127672836275,5,1,3,9,Potential Loyalists
15417,296,1,6095.778278202627,1,1,5,7,Potential Loyalists
15867,237,1,1839.0272169168063,1,1,3,5,At Risk
15672,289,1,2265.832172867186,1,1,3,5,At Risk
11140,44,1,148.9704762528684,4,1,1,6,At Risk
11079,127,1,305.0699877318474,1,1,1,3,Hibernating
13866,305,1,320.0185880486375,1,1,1,3,Hibernating
11465,12,1,4009.3108660152116,5,1,4,10,Loyal Customers
10585,240,1,704.1671466647532,1,1,2,4,At Risk
11819,264,1,5193.804513473046,1,1,5,7,Potential Loyalists
11910,284,1,590.4004888897686,1,1,2,4,At Risk
19095,146,2,4041.7292582662685,1,2,4,7,Potential Loyalists
16915,294,1,238.92353644637762,1,1,1,3,Hibernating
17940,287,1,2568.9771313423694,1,1,4,6,At Risk
12669,300,1,463.8594683105821,1,1,1,3,Hibernating
19953,312,1,345.2150531230055,1,1,1,3,Hibernating
17657,327,1,495.0478571470596,1,1,1,3,Hibernating
17778,129,1,49.75687818010959,1,1,1,3,Hibernating
13854,227,1,4335.11319647585,1,1,4,6,At Risk
18997,306,1,147.3789294712525,1,1,1,3,Hibernating
17237,349,1,2819.703188957765,1,1,4,6,At Risk
19916,74,1,5664.187844352026,3,1,5,9,Potential Loyalists
15708,51,1,420.6819061480842,4,1,1,6,At Risk
17371,247,1,1906.0148281134568,1,1,3,5,At Risk
11515,208,1,1949.7472007062627,1,1,3,5,At Risk
10622,314,1,1738.9155650768348,1,1,3,5,At Risk
10178,36,2,7547.057914073749,4,2,5,11,Loyal Customers
16256,66,2,2284.959322070009,3,2,3,8,Potential Loyalists
15428,318,1,1551.2022663760579,1,1,3,5,At Risk
19290,86,2,5389.435909107219,3,2,5,10,Loyal Customers
13164,251,1,564.9547631147268,1,1,2,4,At Risk
10616,156,1,1894.2033154369185,1,1,3,5,At Risk
11881,197,1,49.98040393056869,1,1,1,3,Hibernating
11505,50,1,1277.4996258965068,4,1,3,8,Potential Loyalists
14267,86,1,602.7771624836598,3,1,2,6,At Risk
14312,263,1,573.3754986583934,1,1,2,4,At Risk
14758,211,1,2389.678135802862,1,1,3,5,At Risk
19898,100,1,2359.3156667203393,2,1,3,6,At Risk
12681,152,1,1159.70634799395,1,1,3,5,At Risk
10692,74,1,3680.7871044392414,3,1,4,8,Potential Loyalists
17354,241,1,2167.0215642612843,1,1,3,5,At Risk
19829,24,1,1362.3001732952227,5,1,3,9,Potential Loyalists
11464,223,1,1987.2503431053206,1,1,3,5,At Risk
18210,131,1,404.63419561205603,1,1,1,3,Hibernating
16502,12,1,3259.8763406449852,5,1,4,10,Loyal Customers
13567,340,1,4619.765388149562,1,1,4,6,At Risk
14218,102,1,793.0154255035691,2,1,2,5,At Risk
13332,155,1,1090.908600104591,1,1,3,5,At Risk
17366,264,1,611.948194018389,1,1,2,4,At Risk
10126,134,1,4518.982059904961,1,1,4,6,At Risk
10790,104,1,5663.230950524511,2,1,5,8,Potential Loyalists
12263,227,1,872.4394757455894,1,1,2,4,At Risk
13744,217,1,3836.78731890213,1,1,4,6,At Risk
12939,122,1,472.6605999352221,1,1,1,3,Hibernating
17349,317,1,548.8521647995447,1,1,2,4,At Risk
15798,150,1,2701.546863938269,1,1,4,6,At Risk
17776,42,1,297.03088601736647,4,1,1,6,At Risk
17942,195,1,2338.512800146537,1,1,3,5,At Risk
17481,266,1,554.0736177360534,1,1,2,4,At Risk
12657,122,2,1422.6247085747561,1,2,3,6,At Risk
15675,230,1,2411.9207259260747,1,1,3,5,At Risk
16135,251,1,915.4290337079163,1,1,2,4,At Risk
19081,217,1,577.4635641861124,1,1,2,4,At Risk
19641,285,1,1929.6175190422384,1,1,3,5,At Risk
19225,46,1,5155.808526224151,4,1,5,10,Loyal Customers
13534,156,1,783.3132741718068,1,1,2,4,At Risk
17766,240,1,794.9578145947293,1,1,2,4,At Risk
12721,54,1,3236.0499246445306,4,1,4,9,Potential Loyalists
10198,53,1,405.47719188063525,4,1,1,6,At Risk
17376,216,1,4444.007467433386,1,1,4,6,At Risk
17037,123,1,804.7443907672803,1,1,2,4,At Risk
17082,27,1,303.11262818527115,5,1,1,7,Potential Loyalists
15109,273,1,1409.5473223816048,1,1,3,5,At Risk
19714,202,1,4646.923042060701,1,1,4,6,At Risk
15229,322,1,1811.324509761067,1,1,3,5,At Risk
16897,4,1,163.18954533880526,5,1,1,7,Potential Loyalists
18890,96,1,548.9785446233968,2,1,2,5,At Risk
19471,183,1,446.9794378886378,1,1,1,3,Hibernating
16448,310,1,645.7876145928908,1,1,2,4,At Risk
18320,197,2,2228.039892345168,1,2,3,6,At Risk
10588,185,1,4694.969863278511,1,1,4,6,At Risk
13150,252,1,5908.097687270787,1,1,5,7,Potential Loyalists
14487,51,1,4081.345731214637,4,1,4,9,Potential Loyalists
16768,185,1,1603.4586982468895,1,1,3,5,At Risk
14340,169,1,2009.1040566247477,1,1,3,5,At Risk
14576,82,1,2259.8788515653537,3,1,3,7,Potential Loyalists
17707,160,1,107.48341364314054,1,1,1,3,Hibernating
13861,5,1,2854.7220864910573,5,1,4,10,Loyal Customers
17954,317,1,4332.720992163754,1,1,4,6,At Risk
18671,299,2,2606.3943446552657,1,2,4,7,Potential Loyalists
17454,22,1,305.4139595490536,5,1,1,7,Potential Loyalists
13138,178,1,1827.7313321551057,1,1,3,5,At Risk
19484,156,1,3577.935621551653,1,1,4,6,At Risk
16380,98,1,8726.878442916264,2,1,5,8,Potential Loyalists
14232,114,1,5542.098047011118,2,1,5,8,Potential Loyalists
12653,336,1,6548.882550058107,1,1,5,7,Potential Loyalists
12220,136,1,360.40212420878424,1,1,1,3,Hibernating
11312,182,1,444.46110437255203,1,1,1,3,Hibernating
10478,62,1,1636.8811690503726,3,1,3,7,Potential Loyalists
15874,119,1,380.26857360477294,2,1,1,4,At Risk
12061,7,1,787.3217922825481,5,1,2,8,Potential Loyalists
14883,168,1,4400.929262026896,1,1,4,6,At Risk
18236,116,1,975.3060575578597,2,1,2,5,At Risk
12387,305,1,263.25801644083833,1,1,1,3,Hibernating
18465,104,2,4379.685916493278,2,2,4,8,Potential Loyalists
10596,195,1,207.7334061493883,1,1,1,3,Hibernating
11802,115,1,2519.7074173445562,2,1,4,7,Potential Loyalists
18411,21,1,465.68329578058496,5,1,1,7,Potential Loyalists
16772,240,1,2954.8875039090854,1,1,4,6,At Risk
12693,232,1,5222.802439008718,1,1,5,7,Potential Loyalists
14435,226,1,608.9562018310038,1,1,2,4,At Risk
17269,224,1,1918.3771555434628,1,1,3,5,At Risk
17876,299,1,1557.203931344402,1,1,3,5,At Risk
19824,305,1,1510.4283765988437,1,1,3,5,At Risk
19053,58,1,932.6435423834428,4,1,2,7,Potential Loyalists
11231,336,1,658.4648606273039,1,1,2,4,At Risk
16280,148,1,1388.4959547873812,1,1,3,5,At Risk
12253,295,1,1750.028041395054,1,1,3,5,At Risk
13981,248,1,692.6747255456405,1,1,2,4,At Risk
10548,275,1,1839.8774630466141,1,1,3,5,At Risk
19743,250,1,821.1394263024856,1,1,2,4,At Risk
13296,321,1,3337.7193310593548,1,1,4,6,At Risk
12999,61,1,4852.500201388883,3,1,4,8,Potential Loyalists
11907,116,2,799.1188125234308,2,2,2,6,At Risk
18456,58,2,1024.4583262371646,4,2,3,9,Potential Loyalists
18033,340,1,1942.5183052293576,1,1,3,5,At Risk
11466,35,1,201.86741020397156,4,1,1,6,At Risk
18488,231,1,518.7166093800682,1,1,2,4,At Risk
13512,344,1,246.4804296066182,1,1,1,3,Hibernating
16559,44,1,722.7156670355209,4,1,2,7,Potential Loyalists
10992,281,1,272.1964141738229,1,1,1,3,Hibernating
13197,193,2,10568.345100994178,1,2,5,8,Potential Loyalists
13823,256,1,294.85205553430984,1,1,1,3,Hibernating
17329,267,1,73.43865991775525,1,1,1,3,Hibernating
17118,162,1,581.3781129295404,1,1,2,4,At Risk
12897,129,1,311.00722664445055,1,1,1,3,Hibernating
13560,140,1,6704.612443726463,1,1,5,7,Potential Loyalists
17951,279,1,2473.996874057327,1,1,3,5,At Risk
19356,54,1,259.28502714668224,4,1,1,6,At Risk
11203,84,1,4936.657099581607,3,1,4,8,Potential Loyalists
19281,137,1,146.2632332900374,1,1,1,3,Hibernating
18504,195,1,4442.290959360325,1,1,4,6,At Risk
10609,79,1,3761.6060441275577,3,1,4,8,Potential Loyalists
15596,51,1,2292.363554131815,4,1,3,8,Potential Loyalists
12038,51,1,9046.099932107594,4,1,5,10,Loyal Customers
14797,324,1,259.0916911924668,1,1,1,3,Hibernating
19663,145,1,5897.682992360966,1,1,5,7,Potential Loyalists
18536,3,1,655.7060826594783,5,1,2,8,Potential Loyalists
10919,289,1,965.0280364773423,1,1,2,4,At Risk
12572,208,1,4613.690116490576,1,1,4,6,At Risk
15982,268,1,1864.3282201112238,1,1,3,5,At Risk
10924,264,1,4549.9467733796255,1,1,4,6,At Risk
15622,305,1,1886.976943002643,1,1,3,5,At Risk
11966,248,1,1582.7495164154204,1,1,3,5,At Risk
12547,82,1,2868.5291791117465,3,1,4,8,Potential Loyalists
18976,55,1,1374.1372002343037,4,1,3,8,Potential Loyalists
10298,12,1,2218.3177877221274,5,1,3,9,Potential Loyalists
12521,27,1,2457.2848579857173,5,1,3,9,Potential Loyalists
13158,10,1,2339.860459076419,5,1,3,9,Potential Loyalists
16582,172,1,338.4971683127342,1,1,1,3,Hibernating
17206,308,1,318.43135912747124,1,1,1,3,Hibernating
15037,219,1,309.7490368164965,1,1,1,3,Hibernating
19637,123,1,778.6438479873225,1,1,2,4,At Risk
15650,338,1,186.61209144551844,1,1,1,3,Hibernating
14239,278,1,2485.49463885802,1,1,3,5,At Risk
15807,357,1,344.96364962977617,1,1,1,3,Hibernating
11916,213,1,5915.409336699968,1,1,5,7,Potential Loyalists
17116,226,1,6644.7511160147715,1,1,5,7,Potential Loyalists
19846,276,1,1577.0015034762762,1,1,3,5,At Risk
10547,3,1,4063.341201487031,5,1,4,10,Loyal Customers
14136,316,1,397.1253351523604,1,1,1,3,Hibernating
18718,162,1,1816.875347715376,1,1,3,5,At Risk
15581,334,1,329.2595755404751,1,1,1,3,Hibernating
13144,97,1,5232.363933678459,2,1,5,8,Potential Loyalists
13998,115,1,329.29727312385177,2,1,1,4,At Risk
13862,348,1,72.3994595539209,1,1,1,3,Hibernating
16222,33,1,945.348236881389,4,1,2,7,Potential Loyalists
10305,137,1,2948.2964791924774,1,1,4,6,At Risk
16869,8,1,11425.124351333345,5,1,5,11,Loyal Customers
18872,168,1,2448.904273995675,1,1,3,5,At Risk
17697,209,1,1739.8925538499434,1,1,3,5,At Risk
16487,97,1,972.5743401901973,2,1,2,5,At Risk
12181,52,3,5161.077040577129,4,2,5,11,Loyal Customers
15730,18,2,4160.672905839736,5,2,4,11,Loyal Customers
15565,210,1,1716.3090337092683,1,1,3,5,At Risk
12223,55,1,540.1615525147877,4,1,2,7,Potential Loyalists
16748,237,1,3760.8521216399563,1,1,4,6,At Risk
16943,317,1,1212.66296832806,1,1,3,5,At Risk
16453,189,1,1164.8872047793761,1,1,3,5,At Risk
12809,166,1,5156.335373618795,1,1,5,7,Potential Loyalists
13565,98,1,634.9756249067424,2,1,2,5,At Risk
18802,286,2,4490.133977053022,1,2,4,7,Potential Loyalists
18415,155,1,6785.725429598475,1,1,5,7,Potential Loyalists
10060,281,1,455.94644818033487,1,1,1,3,Hibernating
19797,261,1,452.7250011950815,1,1,1,3,Hibernating
16019,341,1,811.1175174675607,1,1,2,4,At Risk
16858,210,1,1895.6984541245677,1,1,3,5,At Risk
18758,307,1,1443.5735716610116,1,1,3,5,At Risk
12256,82,1,457.6570597985583,3,1,1,5,At Risk
14875,148,1,1138.4950758058421,1,1,3,5,At Risk
17099,280,2,1065.0099107330122,1,2,3,6,At Risk
18558,112,1,164.28560924964253,2,1,1,4,At Risk
18844,359,1,625.2548630043012,1,1,2,4,At Risk
15831,9,1,1096.752157107511,5,1,3,9,Potential Loyalists
10923,181,1,1219.7145138186718,1,1,3,5,At Risk
17977,210,1,1260.3424025393174,1,1,3,5,At Risk
12949,282,1,315.23190443021554,1,1,1,3,Hibernating
10515,141,1,841.6678898691955,1,1,2,4,At Risk
10494,310,1,4527.577928762668,1,1,4,6,At Risk
17970,269,1,5228.885793766755,1,1,5,7,Potential Loyalists
13084,2,1,817.4698500929544,5,1,2,8,Potential Loyalists
18220,281,1,3006.9814307370466,1,1,4,6,At Risk
10145,113,1,7506.498234039775,2,1,5,8,Potential Loyalists
12240,212,1,1278.7480389615223,1,1,3,5,At Risk
10437,75,1,565.030604128926,3,1,2,6,At Risk
11268,202,1,940.2197454885335,1,1,2,4,At Risk
12159,196,2,2452.1148002102454,1,2,3,6,At Risk
11813,71,1,2574.547882222376,3,1,4,8,Potential Loyalists
14427,333,1,2257.9065981164813,1,1,3,5,At Risk
16008,256,1,5795.327610031659,1,1,5,7,Potential Loyalists
19654,194,2,1051.1706466805254,1,2,3,6,At Risk
19164,99,1,456.00964103781706,2,1,1,4,At Risk
12600,74,1,1988.380023509006,3,1,3,7,Potential Loyalists
13243,160,1,493.6419598729593,1,1,1,3,Hibernating
15402,176,1,344.82496843382677,1,1,1,3,Hibernating
13183,15,1,4486.40933085627,5,1,4,10,Loyal Customers
15275,74,1,150.63219571525164,3,1,1,5,At Risk
14493,351,1,6883.045419234854,1,1,5,7,Potential Loyalists
12121,98,1,1081.2971816814409,2,1,3,6,At Risk
16322,248,1,3406.3965755457452,1,1,4,6,At Risk
17602,255,1,10712.845770464675,1,1,5,7,Potential Loyalists
15209,246,1,327.9760945357758,1,1,1,3,Hibernating
11128,150,1,1985.8452675235885,1,1,3,5,At Risk
14769,160,1,3623.6032441161647,1,1,4,6,At Risk
15187,294,1,47.10886227680788,1,1,1,3,Hibernating
17788,92,1,1302.8120413527138,2,1,3,6,At Risk
17257,159,1,207.48156602329922,1,1,1,3,Hibernating
15615,228,1,817.7107599214404,1,1,2,4,At Risk
16115,296,1,404.70127556995186,1,1,1,3,Hibernating
10242,54,1,2083.9742621355463,4,1,3,8,Potential Loyalists
14593,291,1,2143.0373288954515,1,1,3,5,At Risk
19775,176,1,86.33116741118997,1,1,1,3,Hibernating
10192,223,1,994.1183556091627,1,1,2,4,At Risk
11499,318,1,3354.000735292397,1,1,4,6,At Risk
13129,280,1,6492.963205163776,1,1,5,7,Potential Loyalists
19311,210,1,155.91041253840703,1,1,1,3,Hibernating
18633,32,1,250.61501734435404,4,1,1,6,At Risk
17211,311,1,429.4911711858741,1,1,1,3,Hibernating
15529,236,1,560.5553949386006,1,1,2,4,At Risk
11340,280,1,949.24883219412,1,1,2,4,At Risk
12476,43,1,317.1385862117476,4,1,1,6,At Risk
10893,122,1,1623.879301432407,1,1,3,5,At Risk
12933,43,1,234.6154948016814,4,1,1,6,At Risk
16103,172,2,2112.599896499295,1,2,3,6,At Risk
15480,200,1,146.44607555326235,1,1,1,3,Hibernating
18697,72,1,2018.2340730676592,3,1,3,7,Potential Loyalists
13161,145,1,720.1023733204806,1,1,2,4,At Risk
17299,109,1,1640.6023816723073,2,1,3,6,At Risk
11230,124,1,3439.9577428926077,1,1,4,6,At Risk
16604,54,1,852.3770487721833,4,1,2,7,Potential Loyalists
13637,150,1,161.5685929272532,1,1,1,3,Hibernating
14479,320,1,2420.650286816047,1,1,3,5,At Risk
17493,80,1,229.03194020072968,3,1,1,5,At Risk
10262,27,1,3741.5716352765207,5,1,4,10,Loyal Customers
17240,246,1,1650.133752390388,1,1,3,5,At Risk
10857,60,1,2325.710377761587,4,1,3,8,Potential Loyalists
12795,117,1,191.70065701905008,2,1,1,4,At Risk
13114,73,1,3493.299604615454,3,1,4,8,Potential Loyalists
15573,39,1,432.89346281440635,4,1,1,6,At Risk
11871,123,1,1017.7866149891129,1,1,3,5,At Risk
13841,353,1,2636.7763709324436,1,1,4,6,At Risk
11409,317,1,1203.0543346228262,1,1,3,5,At Risk
14712,9,1,953.281332436911,5,1,2,8,Potential Loyalists
10941,272,1,773.4914526782209,1,1,2,4,At Risk
15718,241,1,2907.553537738028,1,1,4,6,At Risk
